25
22
4444444144444444414444444
4000001110000000111000004
4000004140000000414000004
4000000100000000010000004
4000000100000000010000004
4000000100000000010000004
4140003130000000515000414
1111111111111111111111111
4140003130000000515000414
4000000100000000010000004
4000000600000000010000004
4000000100000000010000004
4000000100000000010000004
4140002120000000717000414
1111111111111111111111111
4140002120000000717000414
4000000100000000010000004
4000000100000000010000004
4000000100000000010000004
4000004140000000414000004
4000001110000000111000004
4444444144444444414444444
