19
15
4444144444444414444
4001110000000111004
4004140000000414004
4143130000000515414
1111111111111111111
4143130000000515414
4000100000000010004
4000100000000010004
4000100000000010004
4142120000000717414
1111111111111111111
4142120000000717414
4004140000000414004
4001110000000111004
4444144444444414444
