52
40
9999999999999999999999999999999999999999999999999999
9444444444444494444444444444444444444444444444444449
9444444414444494444444441444441444444441444441444449
9444444111444494444444411144411144444411144411144449
9444400414000094444000041400041400000001000041444449
9444400080000094444000001000001000000001000001044449
9444400010000094444000001000001000000001000001044449
9444400010000094444000001000001000000001000001044449
9444400010000094414000051500071741400051500071741449
9444400010000094111111111111111111111111111111111149
9444400010000094414000051500071741400051500071741449
9444400010000000000000001000001001000001000001044449
9441400212000000000000071741421271741401000001044449
9411111111111111111111111111111111111101000001044449
9441400212000000000000071741421271741401000001044449
9444400414000000000000001001041401000001000001044449
9444400111000090000000001001011101000001000001044449
9444400414000090000000001001041401000001000001044449
9444444444444494444440041431300021241401000001044449
9999999999999994444140011111111111111101000001044449
9444444444444444441110041431300021241401000001044449
9444400414000000004140000001000041400001000001044449
9444400111000000000100000001000011100001000001044449
9444400414000000000100000001000041400001000001044449
9441400313000000005150041421200000000071741401044449
9411111111111111111111111111111111111111111101044449
9441400313000000005150041421200000000071741401044449
9444400010000000000100000000041400000041400001044449
9444400010000000000100000000011100000011100001044449
9444400010000000000100000000041400000041400001044449
9441400212004140003130000000031300000000000021241449
9411111111111111111111111111111111111111111111111149
9441400212004140003130000000031300000000000021241449
9444400010000000000100000000001000000000000001044449
9444400060000000000100000000001000000000000001044449
9444444414444444444144444444441444444444444441444449
9444444111444444441114444444411144444444444411144449
9444444414444444444144444444441444444444444441444449
9444444444444444444444444444444444444444444444444449
9999999999999999999999999999999999999999999999999999

Key:
1 : Black, Main Line
2 : Blue, Junction Color, North
3 : Green, Junction Color, East
4 : Yellow, End Of Line Color
5 : Red, Junction Color, South
7 : Brown, Junction Color, West
9 : Blocked

6 : Robot Start
8 : Robot Finish
